..............................................
..............................................
..............................................
..............................................
............!.................................
......................................!.......
..............................................
..................%%%.........................
..............................................
..............................................
.............%%%%..,.........%%%..,..?........
.@......%...............%%..............%....
##############################################