........................................................................................................#
........................................................................................................#
........................................................................................................#
.................................................................................!......................#
............!...........................................................................................#
......................................!............................!....................................#
........................................................................................................#
..................%%%...................................................................................#
.....................................?????????..........................................................#
.....................%?%?%..............................................................................#
.............%%%%..,.........%%%..,................|......|...,...................,.....................#
.@......%...1....................1......%...............................................................#
####..###################################################################################################