...................#..............................................#...................
...................#..............................................#...................
...................#..............................................#...................
...................#..............................................#...................
...................#..............................................#...................
...................#............!.........%%....!.........!.......#...................
...................#..............................................#...................
...................#..................%%%................%%.......#...................
...................#...!...............%..........................#...................
...................#.........%%.......%%...?.......%%..........=..#...................
...................#.................,...........?....,..?........#...................
...................#.@..%.........%%........................%.....#...................
...................#########..###########....######################...................