........................................................................................................
........................................................................................................
........................................................................................................
.................................................................................!......................
............!...........................................................................................
......................................!............................!....................................
........................................................................................................
..................%%%...................................................................................
.........................?..............................................................................
.....................................?#?#?..............................................................
.............%%%%..,.........%%%..,................|......|...,...................,.....................
.@......%...............%%..............................................................................
########################################################################################################