......?.......................................
..................................?...........
......%%......................................
..................................%...........
............%.................................
....................................!..%......
...........%............%%....................
.......!......................................
.................!...%........!.....%.........
..............................................
....,...%%.......?..%%...............,........
..@..................................%%.......
##############################################