...................#..............................................#...................
...................#..............................................#...................
...................#..............................................#...................
...................#..............................................#...................
...................#..............................................#...................
...................#............!.........%%....!.........!.......#...................
...................#..............................................#...................
...................#..................%%%................%%.......#...................
...................#...!...............%..........................#...................
...................#.........%%.......%%...?.......%%.............#...................
...................#.........,.......,...........?....,..?.....|..#...................
...................#.@..%.........%%........................%.....#...................
...................#########..###########....######################...................