......?.......................................#
..................................?...........#
......%%......................................#
..................................%...........#
............%.................................#
....................................!..%......#
...........%............%%....................#
.......!......................................#
.................!...%........!.....%.........#
..............................................#
....,...%%.......?..%%...............,........#
..@..................................%%.......#
###############################################