#..............................................#
#..............................................#
#..............................................#
#..............................................#
#..............................................#
#............!.........%%....!.........!.......#
#..............................................#
#..................%%%................%%.......#
#...!...............%..........................#
#.........%%.......%%...?.......%%.............#
#.........,.......,...........?....,..?.....|..#
#.@..%.........%%........................%.....#
#########..###########....######################