........................................................................................................#
........................................................................................................#
........................................................................................................#
.................................................................................!......................#
............!...........................................................................................#
......................................!............................!....................................#
........................................................................................................#
..................%%%...................................................................................#
........................................................................................................#
........................................................................................................#
.............%%%%..,..?......%%%..,..?.............|......|...,...................,.....................#
.@......%...............%%..............%...............................................................#
####..###################################################################################################