..............................................
..............................................
..............................................
..............................................
..............................................
............!.........%%....!.........!.......
..............................................
..................%%%................%%.......
...!...............%..........................
.........%%.......%%...?.......%%.............
.........,.......,................,..?........
.@..%.........%%........................%.....
##############################################