........................................................................................................
........................................................................................................
........................................................................................................
.................................................................................!.......................
............!...........................................................................................
......................................!............................!....................................
........................................................................................................
..................%%%...................................................................................
........................................................................................................
........................................................................................................
.............%%%%..,.........%%%..,..?.............|..........,...................,.....................
.@......%...............%%..............%...............................................................
########################################################################################################