..............................................
..............................................
..............................................
..............................................
..............................................
..............................................
..............................................
..................%%%.........................
..............................................
..............................................
.............%%%%............%%%..............
.@......%...............%%...............%....
##############################################