..............................................#
..............................................#
..............................................#
..............................................#
..............................................#
............!.........%%....!.........!.......#
..............................................#
..................%%%................%%.......#
...!...............%..........................#
.........%%.......%%...?.......%%.............#
.........,.......,................,..?........#
.@..%.........%%........................%.....#
###############################################